##########
#S#      #
# ###### #
#    #   #
# #   #  #
# #      #
##########