########################################
#S                                     #
#   #######        ######              #
#   #     #        #    #   #######    #
#   #     ####     #    #   #     #    #
#   #        #     #    #   #     #    #
#   ####     #     ######   #     #    #
#      #     #              #     #    #
#      #     ###########    #######    #
#      #                 ##            #
#   #######   #########   ##   ######  #
#         #   #       #        #       #
#         #   #       ##########   ##  #
#         #                       ##   #
########################################