############################################################
#S                                                         #
#   ###        ###          ###        ###                 #
#   #          #            #          #                   #
#   #          ######       #          ######              #
#   #                      ###                             #
#   #######        ###             ###                     #
#            ###         #######                           #
#   ###      #                 #                           #
#   #        #                 #                           #
#   #        #######     ###    #######                    #
#   #                ###                                   #
#   ###     ###            ###                             #
#           #                 #                            #
#           #                 #                            #
#   ####    #######     ###   #######                      #
#                        #                                 #
#                        #                                 #
#   ###        ###       #        ###                      #
############################################################