########################
#S                     #
##  #  #          #    #
### #     ##          ##
#         ##       #   #
#######          ##### #
#            ###### ## #
#      #####           #
########################